#                        #######
#                              #
#                              #
#########                      #
                            ####





               #
               #       ###
               #         #
               #         #
         #############   #
                         #
                      ####

               #
               #
    #          #
    #          #
               #           ####
