

   #   #               #    #
   #           ##           #
   #   ##                   #
   #             ##         #
   #                        #

     ######################

   #   #              ###   #
   #    ##     ##           #
   #                    #   #
   #  ###     #      ##     #

     #######################

   #       ##            ## #
   #    ##          ##      #
   #     ##     ##       ## #
   #              ##        #


